ремонт;стоимость;операции;отправки;возвраты;гарантийные;негарантийные;результат
1;1000;3;0;0;1;0;0.5
1;1000;3;0;0;1;0;0.5
2;2000;4;0;0;1;1;0.5
3;5000;4;0;0;1;2;0.5
4;4000;4;0;0;1;3;0.5
5;5000;5;0;0;1;4;0.5
6;2000;3;0;0;1;5;0.5
10;10000;10;5;0;5;5;0.1
15;8000;20;4;0;4;11;0.1
16;12000;4;3;0;3;13;0.1
17;15000;21;8;0;1;16;0.1
18;16000;15;5;0;2;16;0.1
10;17000;14;6;0;5;5;0.1
9;18000;13;2;0;8;1;0.1
